0 0 0 0 0 0 0 10 11 12 0 0 0 0 0 0 0 0 0 0 0 
0 0 0 0 0 1 2 2 2 2 2 3 0 0 0 0 0 0 0 0 0 
0 0 0 0 1 5 5 5 5 5 5 5 3 0 0 0 0 0 0 0 0 
0 0 0 0 7 5 5 5 5 5 5 5 9 0 0 0 0 0 0 0 0 
0 0 0 0 0 4 5 5 5 5 5 6 0 0 0 0 0 0 0 0 0 
0 0 0 0 0 4 5 5 5 5 5 5 3 0 0 0 0 0 0 0 0 
0 0 0 1 2 5 5 5 5 5 5 5 5 2 3 0 0 0 0 0 0 
0 0 0 4 5 5 5 5 5 5 5 5 5 5 6 0 1 2 2 2 3 
1 2 2 5 5 5 5 5 5 5 5 5 5 5 5 2 5 5 5 5 6 
7 8 8 8 8 8 8 8 8 8 8 8 8 8 8 8 8 8 8 8 9 