0 0 0 12 12 0 0 0 0 
0 0 12 12 0 12 12 0 0 
0 12 0 0 0 0 0 12 0 
0 0 0 0 0 0 0 0 12 
0 12 0 0 0 0 0 0 12 
12 0 0 0 11 0 0 0 12 
12 12 0 0 12 0 0 0 12 
0 12 12 12 12 12 12 12 12 