0 0 0 0 0 0 0 0 13 13 13 13 0 0 0 0 0 0 0 0 0 0 0 13 13 13 13 0 0 0 0 0 0 0 0 0 
0 0 0 0 0 0 0 0 0 0 0 0 13 0 0 0 12 0 0 0 0 0 13 0 12 12 0 13 0 0 0 0 0 0 0 0 
0 0 0 11 0 0 0 12 0 0 0 0 0 13 0 12 12 12 0 0 0 13 0 12 12 12 12 0 13 0 0 0 0 0 0 12 
1 2 2 2 2 2 2 2 2 2 2 2 2 2 2 2 2 2 2 2 2 2 2 2 2 2 2 2 2 3 0 0 10 0 0 1 
4 12 12 12 12 0 0 0 0 0 0 0 0 0 12 12 12 12 12 0 0 0 0 0 0 0 0 0 0 0 0 0 0 0 0 4 
4 12 12 12 0 0 0 0 0 0 0 0 0 0 0 12 12 12 0 0 0 0 0 0 0 0 0 0 0 0 0 0 0 0 0 4 
4 12 12 0 0 0 0 0 0 0 0 0 0 0 0 0 12 0 0 0 0 0 13 13 0 0 0 0 0 0 0 0 0 0 0 4 
4 12 0 0 0 0 0 0 0 0 0 0 0 0 0 0 0 0 0 0 0 13 12 12 13 0 0 0 0 0 0 0 0 0 0 4 
4 0 0 0 0 0 0 0 0 0 0 0 0 0 0 0 0 0 0 0 0 1 2 2 3 0 0 0 0 0 0 0 0 0 0 4 
4 0 0 0 10 0 0 0 0 0 12 0 0 0 0 0 0 0 1 2 2 8 8 8 8 2 2 2 2 2 2 2 2 2 2 6 
4 0 0 0 0 0 0 0 0 12 12 12 0 0 0 0 0 0 4 0 0 0 0 0 0 0 0 0 0 0 0 0 0 0 0 4 
4 0 0 0 1 2 2 2 2 2 2 2 2 2 2 2 2 2 9 0 0 0 0 0 0 0 0 0 0 0 0 0 0 0 0 4 
4 0 0 0 0 0 0 0 0 0 0 0 0 0 0 0 0 0 0 0 0 0 0 0 0 0 0 0 0 0 0 0 0 0 0 4 
4 0 0 0 0 0 0 0 0 0 0 0 0 0 0 0 0 0 0 0 0 0 0 0 0 0 0 0 10 0 0 0 0 0 0 4 
4 0 0 0 0 0 0 0 0 0 0 0 0 0 0 0 0 0 0 0 0 0 0 0 0 0 0 0 0 0 0 0 0 0 0 4 
4 0 0 0 1 2 2 2 2 2 2 2 2 2 3 0 0 0 0 0 0 0 0 0 0 0 0 0 0 0 0 0 0 0 0 4 
4 0 0 0 0 0 0 0 0 0 0 0 0 0 0 0 0 0 0 0 0 0 0 0 0 0 0 0 0 0 0 0 0 0 0 4 
4 0 0 0 0 0 0 0 0 0 0 0 0 0 0 0 0 0 0 1 2 2 2 2 3 0 0 0 0 0 0 0 0 0 0 4 
4 12 0 0 0 0 0 0 0 0 0 0 0 0 0 0 0 0 1 8 8 8 8 8 6 0 0 0 0 0 0 0 0 0 0 4 
4 12 12 0 0 13 13 13 13 13 13 13 0 0 0 0 0 0 0 0 0 0 0 12 4 2 2 2 2 2 2 3 0 0 0 4 
4 2 2 2 2 2 2 2 2 2 2 2 2 2 2 2 2 2 2 3 13 13 13 0 7 8 8 8 8 8 8 6 0 0 0 4 
4 0 0 0 0 12 12 12 12 12 12 0 0 0 0 0 0 0 0 4 12 13 13 13 13 0 0 0 0 0 12 4 0 0 0 4 
4 0 0 0 0 0 12 12 12 12 0 0 0 0 0 0 0 0 0 7 2 2 2 2 2 2 2 3 13 0 0 4 0 0 0 4 
4 0 0 0 0 0 0 12 12 0 0 0 0 0 0 0 0 0 0 0 0 0 0 0 0 0 0 0 13 0 0 4 0 0 0 4 
4 0 0 0 0 0 0 0 0 13 0 0 0 0 0 0 0 0 0 0 1 2 2 2 2 2 2 2 3 12 12 4 0 0 0 4 
4 0 0 0 0 0 0 0 13 0 0 0 0 0 0 0 1 2 2 2 8 8 8 8 8 8 8 8 8 2 2 9 0 0 0 4 
4 0 0 0 0 0 0 13 0 0 0 12 0 0 0 0 0 0 0 0 12 0 0 0 13 13 13 0 0 0 0 0 0 0 0 4 
4 0 10 0 0 0 13 0 0 0 12 12 12 0 0 0 0 0 0 0 0 0 0 0 13 12 13 0 0 0 0 0 0 0 0 4 
7 2 2 2 2 2 2 2 2 2 2 2 2 2 2 2 2 2 2 2 2 2 2 2 2 2 2 2 2 2 2 2 2 2 2 9 