1 2 2 2 2 2 2 2 2 2 2 2 2 2 2 2 2 2 2 2 2 2 2 2 2 2 2 2 2 2 2 2 2 2 2 2 2 2 2 2 2 2 2 2 2 2 3 
4 5 5 5 8 9 12 0 0 0 0 0 0 0 0 0 7 8 8 8 9 0 0 0 0 0 0 0 0 0 0 0 0 0 0 0 0 0 0 0 0 0 0 10 0 0 4 
4 8 8 9 12 0 0 0 0 0 0 0 0 0 0 0 0 0 0 0 0 0 0 0 0 0 0 0 0 0 0 0 0 0 0 0 0 0 0 0 0 0 1 2 3 0 4 
4 12 0 0 0 0 0 0 0 0 0 0 0 0 0 0 0 0 0 0 0 0 0 0 0 0 0 0 0 0 0 0 0 0 0 0 0 0 0 0 0 0 0 0 0 0 4 
4 0 0 0 0 0 0 0 0 1 2 2 3 0 0 0 0 0 0 1 2 2 2 3 0 0 0 0 1 2 2 2 2 3 0 0 0 0 0 0 0 0 0 0 0 0 4 
4 0 0 0 0 0 0 1 2 9 12 0 0 0 0 11 0 0 0 4 12 12 12 4 0 0 0 1 5 8 8 8 8 5 3 0 0 0 0 0 0 0 0 0 1 2 6 
4 0 0 0 0 0 0 4 12 0 0 0 0 0 1 2 3 0 0 4 0 0 0 4 0 0 1 5 9 12 12 12 12 7 5 3 0 0 0 0 0 0 0 0 7 8 6 
4 0 0 0 0 0 0 4 0 0 0 0 0 0 4 5 5 2 2 9 0 0 0 7 2 2 5 6 0 0 0 0 0 0 4 6 0 0 0 0 0 0 0 0 0 12 4 
4 0 0 0 0 0 0 7 2 2 2 2 2 2 8 8 8 8 9 0 0 10 0 0 4 5 5 6 0 0 0 0 0 0 7 8 2 2 2 2 2 2 3 0 0 0 4 
4 3 0 0 0 0 0 0 0 0 0 0 0 0 0 0 0 0 0 0 0 0 0 0 4 5 5 6 10 0 1 3 0 0 0 0 0 0 0 0 0 0 0 0 0 0 4 
4 5 2 3 0 0 0 0 0 1 2 2 2 2 2 2 2 2 2 2 2 2 2 2 5 5 5 5 2 2 5 5 2 3 0 0 0 0 0 0 0 0 0 0 0 0 4 
7 8 8 8 2 2 2 2 2 8 8 8 8 8 8 8 8 8 8 8 8 8 8 8 8 8 8 8 8 8 8 8 8 8 2 2 2 2 2 2 2 2 2 2 2 2 9 