0 0 0 1 2 2 2 2 2 2 2 2 2 2 2 2 2 2 2 2 2 2 2 2 2 2 2 2 2 2 2 2 2 3 0 0 0 0 0 0 0 0 0 0 0 0 0 0 0 0 0 0 0 0 0 0 0 
0 0 1 9 12 0 0 0 0 0 0 0 0 0 0 0 12 4 12 0 0 0 0 0 0 10 0 0 0 0 0 0 12 4 0 0 0 0 0 0 0 0 0 0 0 0 0 0 0 0 0 0 0 0 0 0 0 
0 1 9 12 0 0 0 0 0 0 0 0 0 0 0 0 0 4 0 0 0 0 0 0 0 1 0 0 0 0 0 0 0 4 0 0 0 0 0 0 0 0 0 0 0 0 0 0 0 0 0 0 0 0 0 0 0 
1 6 12 0 10 0 0 0 0 1 2 3 0 0 0 0 0 4 0 0 1 2 3 0 0 7 0 0 1 2 3 0 0 4 0 0 0 0 0 0 0 0 0 0 0 0 0 0 0 0 0 0 0 0 0 0 0 
7 6 0 0 0 0 0 0 0 4 5 6 0 0 0 0 1 6 0 0 4 12 7 0 0 11 0 0 7 12 4 0 0 4 0 0 0 0 0 0 1 3 0 0 0 0 0 0 0 0 0 0 0 0 0 0 0 
0 4 2 2 2 2 2 2 2 8 8 9 0 0 0 1 5 6 0 0 4 10 0 0 1 2 3 0 0 10 4 0 0 4 0 0 0 0 0 1 5 5 3 0 0 0 0 0 0 0 0 0 0 0 0 0 0 
0 4 12 0 0 0 0 0 0 0 0 0 0 0 0 7 8 6 0 0 7 2 2 2 8 8 8 2 2 2 9 0 0 4 0 0 0 0 1 8 8 8 8 3 0 0 0 0 0 0 0 0 0 0 0 0 0 
0 4 12 0 0 0 0 0 0 0 0 0 0 0 0 0 12 4 0 0 0 0 0 0 0 0 0 0 0 0 0 0 0 4 0 0 0 0 4 12 12 12 12 4 0 0 0 0 0 0 0 0 0 0 0 0 0 
0 7 2 3 0 0 0 0 1 2 2 2 3 0 0 0 0 4 0 0 0 0 0 0 0 10 0 0 0 0 0 0 0 7 2 2 2 2 9 0 0 0 0 7 2 2 2 2 2 2 3 0 0 0 0 0 0 
0 0 0 4 0 0 0 0 0 0 0 7 8 2 2 2 2 9 0 0 1 2 2 2 2 2 2 2 2 2 3 0 0 0 0 0 0 0 0 0 0 0 0 0 0 0 0 0 0 0 4 0 0 0 0 0 0 
0 0 0 4 0 0 0 0 0 0 0 0 0 0 0 0 0 0 0 0 0 0 0 0 0 0 0 0 0 0 0 0 0 0 0 0 0 0 0 0 0 0 0 0 0 0 0 0 0 0 4 0 0 0 0 0 0 
0 0 0 4 12 12 1 2 2 3 0 0 0 0 0 0 0 0 0 0 0 0 0 0 0 0 0 0 0 0 0 0 0 0 0 0 0 0 0 0 0 0 0 0 0 0 1 2 3 0 4 0 0 0 0 0 0 
0 0 0 7 2 2 8 8 8 8 2 2 2 2 2 2 2 2 2 3 0 0 0 0 0 0 0 0 0 0 0 1 2 2 2 2 2 2 2 2 3 0 0 0 0 0 4 0 0 0 4 0 0 0 0 0 0 
0 0 0 0 0 0 0 0 0 0 0 0 0 0 0 0 0 0 0 0 0 1 2 2 2 2 2 2 2 3 0 0 0 0 0 0 0 0 0 0 4 0 0 0 0 12 4 0 10 0 4 0 0 0 0 0 0 
0 0 0 0 0 0 0 0 0 0 0 0 0 0 0 0 0 0 0 0 0 0 0 0 0 0 0 0 0 0 0 0 0 0 0 0 0 0 0 0 4 0 0 0 0 1 8 2 2 2 5 2 2 2 3 0 0 
0 0 0 0 0 0 0 0 0 0 0 0 0 0 0 0 0 0 0 0 0 0 0 0 0 0 0 0 0 0 0 0 0 0 0 0 0 0 0 0 7 2 3 0 0 0 0 0 12 12 7 9 12 12 7 2 3 
0 0 0 0 0 0 0 0 0 0 0 0 0 0 0 0 0 0 0 0 0 0 0 0 0 0 0 0 0 0 0 0 0 0 0 0 0 0 0 0 0 0 4 0 0 0 0 0 0 0 0 0 0 0 0 0 4 
0 0 0 0 0 0 0 0 0 0 0 0 0 0 0 0 0 0 0 0 0 0 0 0 0 0 0 0 0 0 0 0 0 0 0 0 0 0 0 0 0 0 4 0 0 0 0 0 0 0 0 0 0 0 10 0 4 
0 0 0 0 0 0 0 0 0 0 0 0 0 0 0 0 0 0 0 0 0 0 0 0 0 0 0 0 0 0 0 0 0 0 0 0 0 0 0 0 0 0 7 2 2 2 2 3 0 0 0 0 0 0 1 2 6 
0 0 0 0 0 0 0 0 0 0 0 0 0 0 0 0 0 0 0 0 0 0 0 0 0 0 0 0 0 0 0 0 0 0 0 0 0 0 0 0 0 0 0 0 0 0 0 7 2 2 2 2 2 2 8 8 9 