0 0 0 0 0 0 0 0 0 0 0 0 0 0 0 0 0 0 0 0 0 0 0 0 0 0 0 0 0 0 0 0 0 0 0 0 0 0 0 0 0 0 0 0 0 1 3 
0 0 0 0 0 0 0 0 0 0 0 0 0 0 0 0 0 0 0 0 0 0 0 0 0 0 0 0 0 0 0 0 0 0 0 0 0 0 0 0 0 0 0 0 0 4 6 
0 0 0 0 0 0 0 0 0 0 0 0 0 0 0 0 0 0 0 0 0 0 0 0 0 0 0 0 0 0 0 0 0 0 0 0 0 0 0 0 0 0 0 0 0 4 6 
0 0 0 0 0 0 0 0 0 0 0 0 0 0 0 0 0 0 0 0 0 0 0 0 0 0 0 0 0 0 0 0 0 0 0 0 0 0 0 0 0 0 0 0 0 4 6 
0 0 0 0 0 0 0 0 0 0 0 0 0 0 0 0 0 0 0 0 0 0 0 0 0 0 0 0 0 0 0 0 0 0 0 0 0 0 0 0 0 0 0 0 0 4 6 
0 0 0 0 0 0 0 0 0 0 0 0 0 0 0 0 0 0 0 0 0 0 0 0 0 0 0 0 0 0 0 0 0 0 0 0 0 0 0 0 0 0 0 0 0 4 6 
1 3 0 0 0 0 0 0 0 0 0 0 0 0 0 0 0 0 0 0 0 0 0 10 0 0 0 0 0 0 0 0 0 10 0 0 0 0 0 0 0 0 0 0 0 4 6 
4 6 0 0 0 0 0 0 0 0 0 0 0 0 0 0 0 0 0 0 0 0 1 2 3 0 0 0 0 0 0 0 1 2 3 0 0 0 0 0 0 0 0 0 0 4 6 
4 6 0 0 0 0 0 0 0 0 0 0 0 0 0 0 0 0 0 0 0 0 7 5 5 3 0 0 0 0 0 1 5 5 9 0 0 0 0 0 0 0 0 0 0 4 6 
4 6 0 0 0 0 0 0 0 0 0 0 0 0 0 0 0 0 0 0 0 0 12 7 8 9 0 0 0 0 0 7 8 9 12 0 0 0 0 0 0 0 0 0 0 4 6 
4 6 0 0 0 0 0 0 0 0 0 0 0 0 0 0 0 0 0 0 0 0 0 0 0 0 0 0 10 0 0 0 0 0 0 0 0 0 0 0 0 0 0 0 0 4 6 
4 6 0 10 0 0 0 0 0 0 0 0 0 0 0 0 0 0 0 0 0 0 0 0 0 0 0 1 2 3 0 0 0 0 0 0 0 0 0 0 0 0 0 0 0 4 6 
4 6 0 1 0 0 0 0 0 0 0 0 0 0 0 0 0 0 0 0 0 0 0 1 2 2 2 5 5 5 2 2 2 3 0 0 0 0 0 0 0 0 0 0 0 4 6 
4 6 0 4 0 0 0 0 0 0 0 0 0 0 0 0 0 0 0 0 0 0 1 5 8 8 8 8 8 8 8 5 5 5 3 0 0 0 0 0 0 0 0 0 0 4 6 
4 6 0 7 3 0 0 0 0 0 0 0 0 0 0 0 0 0 0 0 0 1 5 6 12 0 0 0 0 0 12 4 8 8 8 2 2 3 0 0 0 0 0 0 0 4 6 
4 6 0 0 0 0 0 1 3 0 0 0 0 0 0 1 2 2 2 2 2 8 8 9 0 0 0 10 0 0 0 7 0 0 0 0 10 4 0 0 0 0 0 0 0 4 6 
4 6 0 0 0 0 0 4 6 0 0 0 0 0 0 4 0 0 0 0 0 0 0 0 0 0 1 2 3 0 0 0 0 1 2 2 2 8 2 2 2 2 3 10 1 5 6 
4 6 0 0 0 0 0 4 6 0 0 0 0 0 0 4 0 0 1 2 3 0 0 0 0 0 0 0 0 0 0 0 1 8 9 12 0 0 0 0 12 4 5 2 5 5 9 
4 5 2 2 2 3 12 4 6 0 0 0 0 1 2 5 3 0 4 5 6 0 1 0 0 0 0 0 11 0 0 0 0 0 0 0 0 0 0 0 0 7 5 5 5 9 0 
4 5 8 8 8 5 2 5 6 0 0 0 0 4 5 5 6 0 7 5 6 0 4 0 1 2 2 2 2 2 3 0 0 0 0 0 0 0 0 0 0 10 4 5 6 0 0 
4 6 0 0 0 4 5 5 6 0 0 0 1 5 5 8 9 0 0 4 6 0 7 0 4 6 10 0 0 0 7 3 0 0 0 1 2 2 2 2 2 2 5 5 6 0 0 
4 6 0 0 0 4 5 5 6 0 0 0 7 8 9 0 0 0 0 7 6 0 10 0 4 5 2 2 3 0 0 0 0 0 0 4 9 12 7 8 5 5 5 5 9 0 0 
4 6 0 0 0 7 8 5 5 3 0 0 0 0 0 0 1 3 0 0 4 2 2 2 5 5 8 8 8 2 3 0 0 0 0 4 0 0 0 0 7 8 5 6 0 0 0 
4 6 0 0 0 0 0 7 5 5 2 2 2 2 2 2 5 5 3 0 7 8 8 8 8 9 12 12 12 7 8 3 0 1 2 9 0 0 0 0 0 0 4 6 0 0 0 
4 6 0 0 0 0 0 0 7 8 8 8 8 8 8 8 8 5 6 0 0 0 0 0 0 0 0 0 0 0 0 0 0 0 0 0 0 1 2 3 0 10 4 6 0 0 0 
4 5 2 3 0 0 0 0 0 0 0 0 0 0 0 0 0 4 5 2 2 2 2 2 2 2 2 2 2 2 2 2 2 2 2 2 2 5 5 5 2 2 5 6 0 0 0 
4 5 5 6 0 0 0 0 0 0 0 0 0 0 0 0 0 7 8 8 8 8 8 8 8 8 8 8 8 8 8 8 8 8 8 8 8 8 8 8 8 8 8 9 0 0 0 
7 8 8 8 2 3 0 0 0 0 0 0 0 0 0 0 0 0 0 0 0 0 0 0 0 0 0 0 0 0 0 0 0 0 0 0 0 0 0 0 0 0 0 0 0 0 0 