0 0 0 0 0 0 0 0 0 0 0 0 0 0 0 0 0 0 0 0 0 0 0 0 4 
0 0 0 0 0 0 0 0 0 0 0 0 0 0 0 0 0 0 0 0 0 0 0 0 4 
0 0 0 0 0 0 0 0 0 0 0 0 0 0 0 0 0 0 0 0 0 0 0 0 4 
0 0 0 0 0 0 0 0 0 0 0 0 0 0 0 0 0 0 0 0 0 0 0 0 4 
2 3 0 0 0 0 0 0 0 0 0 0 0 0 0 0 0 0 10 0 0 0 0 0 4 
5 6 0 0 0 0 0 0 0 0 0 0 0 0 0 0 0 0 0 0 0 0 0 0 4 
5 6 0 0 0 0 0 0 0 0 0 0 0 0 0 1 2 2 2 2 3 0 0 0 4 
5 6 0 0 0 0 0 0 0 0 0 0 0 0 0 0 0 0 0 0 0 0 0 0 4 
5 6 0 0 0 0 0 0 0 0 10 0 0 0 0 0 0 0 0 0 0 0 0 0 4 
5 6 0 0 0 0 0 0 1 2 2 2 3 0 0 0 0 0 0 0 0 0 0 0 4 
5 6 0 0 0 0 0 0 4 5 5 5 6 0 0 0 0 0 0 0 0 0 0 0 4 
5 6 0 11 0 0 0 0 4 5 5 5 6 0 0 0 0 0 0 0 0 10 0 0 4 
5 5 2 2 2 2 2 2 5 5 5 5 5 2 2 2 2 2 2 2 2 2 2 2 5 