5 8 8 8 8 8 8 8 8 8 8 8 8 8 8 8 8 8 8 8 8 8 8 8 8 8 8 8 8 5 
6 0 0 0 0 0 0 0 0 0 0 0 0 0 0 0 0 0 0 0 0 0 0 0 0 0 0 0 0 4 
6 0 0 0 0 0 10 0 0 0 0 0 0 0 0 0 0 0 0 0 0 0 0 0 0 0 0 0 0 4 
6 0 0 0 0 1 2 3 0 0 0 0 0 0 0 0 0 0 0 0 0 0 0 0 0 0 0 0 0 4 
6 0 0 0 1 5 0 0 0 0 0 0 0 0 0 0 0 0 0 0 0 0 0 0 0 0 0 0 0 4 
6 0 0 0 0 0 0 0 0 0 0 0 0 13 0 0 0 0 0 0 0 0 0 0 0 0 0 0 0 4 
6 0 0 1 3 0 0 0 0 0 0 0 13 13 13 0 0 0 0 0 0 0 0 0 0 0 10 0 0 4 
5 2 0 0 0 0 0 0 0 0 0 1 2 2 2 3 0 0 0 0 0 0 0 0 1 2 2 2 2 5 
6 0 0 0 0 0 0 0 0 0 0 0 0 0 0 0 0 0 0 0 0 0 0 13 13 0 0 0 0 4 
5 2 3 0 0 0 0 0 0 0 0 0 0 0 0 0 0 0 0 0 0 0 0 1 3 0 0 0 0 4 
6 0 0 0 0 13 13 0 0 0 0 0 0 0 0 0 0 0 0 0 0 0 1 5 6 13 0 0 0 4 
6 0 0 0 0 1 3 0 0 0 0 0 0 0 0 0 0 0 0 0 0 1 5 5 5 3 0 0 0 4 
6 0 0 0 0 4 5 0 0 0 0 0 10 0 0 0 0 0 0 0 1 5 5 5 5 6 13 0 0 4 
6 0 0 0 1 5 5 3 0 0 0 0 0 0 0 0 0 0 0 1 5 5 5 5 5 5 3 0 0 4 
6 0 0 1 5 5 5 5 3 0 0 0 0 0 0 0 0 0 1 5 5 5 5 5 5 5 6 13 0 4 
6 0 0 4 5 5 5 5 6 0 0 0 11 0 0 0 0 1 5 5 5 5 5 5 5 5 5 3 13 4 
5 2 2 5 5 5 5 5 5 2 2 2 2 2 2 2 2 5 5 5 5 5 5 5 5 5 5 8 2 9 