1 2 2 2 2 2 2 2 2 2 2 2 3 0 
4 0 0 0 0 0 0 0 0 0 0 0 4 0 
4 0 0 0 0 0 0 0 0 0 0 0 4 0 
4 0 0 0 0 0 0 0 0 0 0 11 4 0 
4 0 13 13 13 13 0 0 0 0 0 1 6 0 
4 0 1 2 2 3 0 0 0 0 0 0 4 0 
4 0 0 0 0 0 0 0 0 0 0 0 4 0 
4 0 0 0 0 0 0 0 0 0 0 0 4 0 
4 0 0 1 2 2 3 0 0 0 0 0 4 0 
4 0 0 0 0 0 0 0 0 0 0 0 4 0 
4 0 0 0 0 0 0 0 0 0 0 0 4 0 
4 0 0 0 0 0 0 0 0 0 0 0 4 0 
4 0 0 0 0 0 0 0 0 0 0 0 4 0 
4 13 13 0 0 13 13 0 0 0 0 0 4 0 
4 2 3 0 0 1 3 0 0 0 0 13 4 0 
4 0 0 0 0 0 0 0 0 0 0 1 6 0 
4 0 0 0 0 0 0 0 0 0 0 4 6 0 
4 0 0 0 0 0 1 0 0 0 13 4 6 0 
4 0 0 0 0 0 0 0 0 0 1 8 6 0 
4 0 0 0 0 0 0 0 0 0 0 0 4 0 
4 0 0 10 0 13 13 0 0 0 0 0 4 0 
4 0 0 0 0 1 3 0 0 0 0 0 4 0 
4 0 0 0 1 5 6 0 0 0 0 0 4 0 
4 0 0 1 5 5 6 0 0 0 0 1 6 0 
4 0 1 5 5 5 6 0 0 10 0 0 4 0 
4 2 5 5 5 5 5 3 13 13 13 13 4 0 
7 8 8 8 8 8 8 8 2 2 2 2 9 0 
0 0 0 0 0 0 0 0 0 0 0 0 0 0 