2 2 2 2 2 2 2 2 2 2 2 2 2 2 2 2 2 2 2 2 2 2 2 2 2 
6 0 0 0 0 0 0 0 0 0 0 0 0 0 0 0 0 0 0 0 0 0 0 0 4 
6 0 0 0 0 0 0 0 10 0 0 0 0 0 1 0 0 0 0 0 0 0 0 0 4 
6 0 0 1 2 2 2 2 3 0 0 0 0 0 6 10 0 13 13 0 0 0 0 0 4 
4 0 0 0 0 0 0 0 0 0 0 0 0 0 7 2 3 0 0 1 2 3 0 0 4 
4 0 0 0 0 0 0 0 0 0 0 0 0 0 0 0 0 0 0 0 0 0 0 0 4 
4 3 0 0 0 0 0 0 0 0 0 0 0 0 0 0 0 0 0 0 0 0 1 2 5 
6 0 0 1 2 2 3 0 0 0 0 0 13 13 13 13 0 0 0 0 0 0 0 0 4 
6 0 0 0 0 0 0 0 0 0 0 13 0 0 0 0 13 0 0 0 0 0 0 0 4 
6 0 0 0 13 13 1 3 0 0 0 0 0 0 0 0 0 0 0 0 0 1 3 0 4 
5 3 0 0 1 2 9 0 0 0 0 0 0 0 0 0 0 0 0 0 1 5 0 0 4 
4 0 0 0 0 0 0 0 0 0 0 11 0 0 0 0 0 0 0 1 9 0 0 0 4 
4 13 0 0 0 0 0 0 0 13 1 2 3 0 0 0 0 13 13 13 13 0 0 0 4 
4 3 13 0 0 2 0 0 0 1 5 6 13 0 0 0 0 1 2 2 3 0 0 0 4 
5 5 3 13 0 0 0 0 13 4 5 6 13 13 0 0 0 0 0 0 5 3 0 0 4 
5 5 5 3 13 13 13 13 1 5 5 6 13 13 13 0 0 0 0 0 0 0 0 0 4 
5 5 5 8 2 2 2 2 8 5 5 8 2 2 2 2 2 2 2 2 2 2 2 2 5 