0 0 0 0 0 0 0 0 0 0 0 0 0 0 0 0 0 0 0 0 
1 2 2 2 2 2 2 2 2 2 2 2 2 2 2 2 2 2 2 3 
6 12 13 0 0 0 0 0 0 0 12 0 0 0 0 0 0 0 12 4 
6 12 13 0 0 0 0 0 0 0 0 0 0 0 0 0 0 0 0 4 
4 2 2 2 2 3 0 0 0 0 0 0 0 12 0 0 1 0 0 4 
4 13 0 0 0 13 13 13 1 2 2 2 2 2 2 3 13 13 13 4 
4 13 0 0 12 1 2 2 6 0 0 0 0 0 12 0 0 1 0 4 
4 13 0 0 0 0 0 0 4 10 0 12 0 0 0 0 0 0 0 4 
4 13 0 0 0 0 0 0 7 2 2 2 2 2 2 3 0 0 0 4 
4 2 2 2 2 2 3 0 0 0 13 13 13 0 0 4 0 10 0 4 
3 12 0 0 0 12 0 0 0 0 0 0 0 0 10 4 0 1 0 4 
6 0 11 0 0 0 0 0 0 0 12 12 12 0 0 4 12 12 12 4 
6 2 2 2 2 2 2 2 2 2 2 2 2 2 2 8 2 2 2 8 