1 2 2 2 2 2 2 2 2 2 2 2 2 2 2 2 2 2 2 2 2 2 3 
4 13 13 13 12 12 0 0 0 0 0 0 0 0 0 0 0 0 0 12 12 12 5 
4 12 0 0 0 0 0 0 0 0 0 0 0 0 0 12 0 0 0 0 0 0 5 
6 12 0 0 0 0 0 0 0 0 0 0 0 0 1 2 2 3 0 0 0 0 5 
6 12 0 0 0 0 0 0 0 13 0 0 0 0 0 13 13 0 0 0 0 0 5 
6 0 0 0 0 0 0 0 12 1 0 0 0 0 0 0 0 0 0 0 0 0 5 
6 0 0 0 0 0 0 0 12 4 0 0 0 0 0 0 0 0 0 0 0 0 5 
6 0 0 0 1 3 0 0 12 4 0 0 0 0 0 0 0 0 0 1 12 0 5 
6 0 0 0 0 0 0 0 0 4 0 0 0 0 12 3 0 0 0 0 0 0 5 
5 3 0 0 0 0 0 0 0 4 0 0 0 0 0 0 0 0 0 0 0 0 5 
6 0 0 0 0 0 0 0 0 4 0 0 0 0 0 0 0 0 0 12 0 10 4 
6 0 0 0 0 0 0 0 0 4 0 0 0 0 0 0 0 1 2 2 2 2 5 
6 0 0 0 0 0 0 0 0 4 0 0 0 0 0 0 0 0 0 0 12 0 4 
5 2 3 13 13 0 0 0 0 4 0 0 0 0 0 13 13 13 13 0 0 0 4 
6 12 12 0 0 13 0 0 0 4 0 0 0 0 13 13 12 12 13 13 0 0 4 
6 0 0 0 0 0 13 0 0 4 0 0 0 12 1 2 2 2 2 3 0 0 4 
6 0 0 0 0 0 13 0 0 4 0 0 0 0 0 0 10 0 0 0 0 0 4 
3 0 0 0 0 0 1 12 0 4 0 0 0 0 0 0 0 0 0 0 0 0 1 
6 0 0 0 0 1 9 12 0 4 0 0 12 12 13 13 12 13 13 12 12 0 4 
6 0 0 1 2 9 0 0 0 7 2 2 2 2 2 2 2 2 2 2 2 2 5 
6 0 0 0 12 12 0 0 0 0 0 13 13 13 13 13 13 13 13 0 0 12 4 
6 0 0 0 0 0 0 0 0 0 0 0 0 0 0 0 0 0 0 0 0 12 4 
4 0 0 0 0 0 0 0 0 0 0 0 0 0 0 0 0 0 0 0 0 12 4 
4 0 0 0 0 0 0 0 0 0 0 0 0 0 0 0 0 0 0 0 0 0 4 
4 3 0 0 0 0 0 0 0 0 0 0 0 0 0 0 0 0 0 0 0 0 4 
5 5 3 0 0 0 0 0 0 0 0 0 0 0 0 13 13 0 0 0 0 0 4 
5 5 5 3 0 0 0 0 0 0 13 13 0 0 1 2 2 3 0 0 0 0 4 
5 5 5 5 3 0 0 0 0 0 1 3 0 0 12 12 12 7 3 0 0 0 4 
5 5 5 5 5 3 0 0 0 0 12 12 0 0 0 0 0 0 7 3 0 0 4 
5 5 5 5 5 5 3 0 0 0 0 0 0 0 0 0 0 0 0 0 0 0 4 
5 5 5 5 5 5 6 12 0 0 0 0 0 0 0 0 0 0 0 0 0 0 4 
5 5 5 5 5 5 6 0 0 0 0 0 0 0 0 0 0 0 0 0 0 13 4 
5 5 5 5 5 5 6 0 0 0 0 0 0 0 0 0 0 0 0 0 13 1 6 
5 5 5 5 5 5 6 12 0 0 0 0 0 0 0 0 0 0 12 12 1 5 5 
5 5 5 5 5 5 6 12 0 0 0 0 0 13 1 2 2 2 2 2 5 5 5 
5 5 5 5 5 5 6 12 0 0 0 0 0 1 5 5 5 5 5 5 5 5 5 
5 5 5 5 5 5 6 0 0 0 0 0 0 4 5 5 5 5 5 5 5 5 5 
5 5 5 5 5 5 6 0 0 11 0 0 1 5 5 5 5 5 5 5 5 5 5 
5 5 5 5 5 5 5 2 2 2 2 2 5 5 5 5 5 5 5 5 5 5 5 