5 5 5 5 5 5 5 5 5 5 5 5 5 5 5 5 5 5 6 0 0 0 0 
5 8 8 8 8 8 8 8 8 8 8 8 8 8 8 8 8 5 6 0 0 0 0 
6 0 0 0 0 0 0 0 0 0 0 0 0 0 0 0 0 4 6 0 0 0 0 
6 0 0 0 0 0 0 0 0 0 0 0 1 3 0 0 0 7 8 8 8 8 5 
6 0 0 0 0 0 0 0 0 0 0 0 0 0 0 0 0 0 0 0 0 0 4 
6 0 0 0 0 0 0 0 0 1 2 2 2 3 0 0 0 0 0 0 0 0 4 
6 0 0 0 0 0 0 0 0 4 6 0 0 0 0 0 0 0 0 0 0 0 4 
6 0 0 0 0 0 0 1 2 8 9 0 0 0 0 0 0 0 0 0 0 0 4 
5 2 3 0 0 0 0 0 0 0 0 0 0 0 0 0 0 0 0 0 0 0 4 
5 5 5 2 2 2 2 2 2 2 2 2 2 2 2 2 2 2 2 2 2 2 5 