0 0 0 0 0 0 0 0 
0 0 0 0 0 0 10 0 
0 0 0 0 0 0 0 0 
0 0 0 0 11 0 0 12 
0 0 0 0 1 2 2 3 