0 1 2 2 3 0 0 0 0 0 0 0 0 1 2 2 3 0 
0 0 0 0 0 0 0 0 0 0 0 0 0 0 0 0 0 0 
1 2 2 2 3 0 0 0 0 0 0 0 0 1 2 2 2 3 
4 0 0 0 0 0 0 0 0 0 0 0 0 0 0 0 0 4 
4 0 0 0 0 0 0 0 0 0 0 0 0 0 0 0 0 4 
4 2 2 3 0 0 0 0 0 0 0 0 0 0 1 2 2 6 
4 0 0 0 0 0 0 0 1 0 1 0 0 0 0 0 0 4 
4 2 3 0 0 0 0 1 0 1 0 1 0 0 0 1 2 6 
4 0 0 0 0 0 0 0 0 0 0 0 0 0 0 0 0 4 
4 0 0 0 0 0 0 11 0 0 0 0 0 0 0 0 0 4 
7 2 2 2 2 2 2 2 2 2 2 2 2 2 2 2 2 9 