5 5 5 5 5 5 5 5 5 5 5 5 5 5 5 5 5 5 6 
5 8 8 8 8 8 8 8 8 8 8 8 8 8 8 8 8 5 6 
6 0 0 0 0 0 0 0 0 0 0 0 0 0 0 0 0 4 6 
6 0 0 0 0 0 0 0 0 0 0 0 1 3 0 0 0 4 6 
6 0 0 0 0 0 0 0 11 0 0 0 10 0 0 0 0 4 6 
6 0 0 0 0 0 0 0 0 1 2 2 2 3 0 0 0 4 6 
6 0 0 0 0 0 0 0 0 4 6 10 0 0 0 0 0 4 6 
6 0 0 0 0 0 0 1 2 8 9 0 0 0 0 0 0 4 6 
5 2 3 0 10 0 0 0 0 0 0 0 0 0 0 0 0 4 6 
5 5 5 2 2 2 2 2 2 2 2 2 2 2 2 2 2 5 6 