1 2 2 2 2 2 2 2 2 2 2 2 2 2 2 2 2 2 2 2 2 2 2 2 2 2 2 2 2 2 2 2 2 2 2 2 2 2 2 2 2 2 2 2 2 2 2 3 
4 0 0 0 0 0 0 0 0 0 0 0 0 0 12 0 0 13 13 13 13 0 0 0 10 0 0 0 12 12 12 13 13 13 13 13 13 13 13 0 0 0 0 0 0 0 0 4 
4 0 0 0 0 0 0 0 0 0 0 0 0 0 12 13 13 13 13 13 13 0 0 0 0 0 0 0 0 0 12 12 13 13 13 13 13 13 0 0 0 0 0 0 0 0 0 4 
4 0 0 0 0 0 0 0 12 0 0 0 0 0 12 13 13 13 13 13 13 0 0 0 12 0 0 0 0 0 0 12 12 13 13 13 13 0 0 0 0 0 0 0 12 0 0 4 
4 0 0 13 13 13 0 0 12 0 0 0 0 0 12 0 0 0 0 0 0 0 0 0 12 0 0 0 0 0 0 0 12 12 13 13 0 0 0 0 0 0 0 12 12 0 0 4 
4 0 13 13 13 13 13 0 12 0 0 0 0 0 12 0 0 0 0 0 0 0 0 12 12 13 0 0 0 0 0 0 0 12 12 0 0 0 0 0 0 0 12 12 12 0 0 4 
4 0 0 13 13 13 0 0 12 0 0 0 0 0 12 0 0 0 0 0 0 0 12 12 13 13 13 0 0 0 0 0 0 0 12 12 0 0 0 0 0 12 12 12 13 0 0 4 
4 0 0 0 0 0 0 0 12 0 0 0 0 0 0 0 0 0 0 0 0 0 12 13 13 13 13 13 0 0 0 0 0 0 0 0 0 0 0 0 12 12 12 13 13 0 0 4 
4 0 11 0 0 0 0 0 12 0 0 0 0 0 10 0 0 0 0 0 0 0 12 13 13 13 13 13 0 0 0 0 0 0 0 10 0 0 0 12 12 12 13 13 13 0 10 4 
7 2 2 2 2 2 2 2 2 2 2 2 2 2 2 2 2 2 2 2 2 2 2 2 2 2 2 2 2 2 2 2 2 2 2 2 2 2 2 2 2 2 2 2 2 2 2 9 