0 0 0 0 0 0 0 10 0 0 0 0 0 0 0 0 0 0 0 0 0 0 0 0 0 0 0 0 0 0 0 0 0 0 0 0 0 0 0 0 0 0 0 0 
0 0 0 0 0 0 0 1 3 0 0 0 0 0 0 0 0 0 0 0 0 0 0 0 0 0 0 0 0 0 0 0 0 0 0 0 0 0 0 0 0 0 0 0 
0 0 0 0 0 0 0 4 6 13 13 13 0 0 0 0 0 0 0 0 0 0 0 0 0 0 0 0 0 0 0 0 0 0 0 0 0 0 0 0 0 0 0 0 
0 0 0 0 0 0 0 4 5 2 2 3 0 0 1 2 2 2 2 2 3 0 0 0 0 0 0 0 0 0 0 0 0 0 0 0 13 13 0 0 0 0 0 0 
0 0 0 1 2 2 2 5 5 8 8 9 0 0 4 6 12 12 0 0 0 0 0 0 0 0 0 0 0 0 0 0 0 0 0 0 1 3 0 0 0 0 0 0 
0 1 2 8 8 8 8 8 9 12 12 12 0 0 4 6 12 0 0 0 0 0 0 0 1 2 3 0 0 0 0 0 0 0 0 1 8 8 3 0 0 0 0 0 
0 0 0 0 12 0 0 0 0 0 0 0 0 0 7 9 0 0 0 0 0 0 0 0 0 0 0 0 0 0 0 0 0 0 0 0 0 0 0 0 0 0 0 0 
0 0 0 0 0 0 0 0 0 0 0 0 0 0 0 0 0 0 0 0 0 0 0 0 0 0 0 0 0 0 0 0 0 0 0 0 0 0 0 0 0 0 0 0 
0 0 0 0 1 0 0 0 0 0 0 0 0 0 0 0 0 0 0 0 0 0 1 3 13 13 13 1 2 2 2 3 13 13 13 0 0 0 0 0 0 0 0 0 
1 2 3 0 7 0 1 2 3 0 0 0 0 0 0 0 0 0 1 2 2 2 8 8 2 2 2 8 8 8 8 8 2 2 3 0 0 0 0 0 0 0 0 0 
0 12 4 0 12 0 4 12 0 0 0 0 0 0 11 0 0 0 4 5 5 9 12 12 12 7 9 12 0 0 0 0 0 0 0 0 0 0 0 0 0 0 0 0 
0 0 4 13 1 13 4 0 0 0 0 0 1 2 2 2 2 2 5 5 9 12 0 0 0 0 0 0 0 0 0 0 0 0 0 13 13 13 0 0 0 0 0 0 
0 0 4 13 7 13 4 0 0 0 0 0 7 8 8 8 8 8 8 9 12 0 0 0 0 0 0 0 0 0 0 0 0 1 2 2 2 2 3 0 0 0 0 0 
0 0 4 13 13 13 4 0 0 0 0 0 0 0 0 0 0 0 0 0 0 0 0 0 0 13 13 0 13 13 13 13 1 5 5 8 8 8 9 0 0 0 0 0 
0 0 7 2 2 2 9 0 0 0 0 0 0 0 0 0 0 0 0 0 0 0 0 0 1 2 2 2 2 2 2 2 8 8 9 0 0 0 0 0 0 0 0 0 
0 0 0 0 0 0 0 0 0 0 0 0 0 0 0 0 0 0 0 0 0 0 0 0 7 8 9 0 0 0 0 0 0 0 0 0 0 0 0 0 0 0 0 0 
0 0 0 0 0 0 0 0 0 0 0 0 0 0 0 0 0 0 13 13 13 13 0 0 0 0 0 0 0 0 0 0 0 0 0 0 0 0 0 0 0 0 0 0 
0 0 0 0 0 0 0 0 0 0 0 0 0 0 0 0 0 0 1 2 2 3 0 0 0 0 0 0 0 0 0 0 0 0 0 0 0 0 0 0 0 0 0 0 
0 0 0 0 0 0 0 0 0 0 0 0 13 13 0 0 0 0 7 8 8 9 0 0 0 0 0 0 0 0 0 0 0 0 0 0 0 0 0 0 0 0 0 0 
0 0 0 0 0 0 0 0 0 0 0 12 1 3 0 0 0 0 0 0 0 0 0 0 0 0 0 0 0 0 0 0 0 10 0 0 0 0 0 0 0 0 0 0 
0 0 0 0 0 0 0 0 0 0 0 1 5 6 0 0 0 0 0 0 0 0 0 0 0 0 0 0 0 0 0 0 0 0 0 0 0 0 0 0 0 0 0 0 
0 0 0 0 0 0 0 0 0 0 0 7 8 8 2 2 3 0 0 0 0 0 0 0 0 0 0 0 0 12 1 2 2 2 2 2 3 12 0 0 0 0 0 0 
0 0 0 0 0 0 0 0 0 0 0 0 0 0 0 0 0 0 0 0 0 0 0 13 13 13 0 1 2 2 5 5 5 5 5 5 5 2 3 0 13 13 13 0 
0 0 0 0 0 0 0 0 0 0 0 0 0 0 0 0 0 0 0 0 0 0 1 2 2 2 2 8 8 8 8 8 8 8 8 8 8 8 8 2 2 2 2 3 