0 0 0 0 0 0 0 0 0 0 0 13 13 0 0 0 0 0 0 0 0 0 0 0 0 
0 0 0 0 0 0 0 0 0 0 0 1 3 0 0 0 0 0 0 0 0 0 0 0 0 
0 0 0 0 0 0 0 0 13 13 13 4 6 0 0 0 0 0 0 0 10 0 0 0 0 
0 0 0 0 0 11 0 0 1 2 2 5 6 12 0 0 0 0 0 0 0 0 0 0 0 
0 0 0 0 1 2 2 2 8 8 8 8 8 2 2 2 2 2 2 2 2 2 2 2 3 
0 0 0 0 0 0 0 0 0 0 0 0 0 0 0 0 0 0 0 0 0 0 0 0 4 
0 0 0 0 0 13 13 0 0 0 0 0 0 0 0 0 0 0 0 0 0 0 0 0 4 
0 0 0 0 0 1 3 0 0 0 0 0 0 0 0 0 0 0 0 0 0 0 1 2 6 
0 0 0 0 1 5 5 3 13 13 13 13 13 13 13 13 13 13 13 13 13 1 5 5 6 
1 2 2 2 8 8 8 8 2 2 2 2 2 2 2 2 2 2 2 2 2 8 8 8 9 