0 0 0 0 0 0 0 0 0 0 0 0 0 0 0 0 0 0 0 0 0 0 0 0 0 0 0 0 0 0 0 0 0 0 0 0 0 0 0 0 0 0 0 0 0 0 0 0 0 1 
0 0 0 0 0 0 0 0 0 0 0 0 0 0 0 0 0 0 0 0 0 0 0 0 0 0 0 0 0 0 0 0 0 0 0 0 0 0 0 0 0 0 0 0 0 0 0 0 0 4 
0 0 0 0 0 0 0 0 0 0 0 0 0 0 0 0 0 0 0 0 0 0 0 0 0 0 0 0 0 0 0 0 0 0 0 0 0 0 0 0 10 0 0 0 0 0 0 0 0 4 
0 0 0 0 0 0 0 0 0 0 0 11 0 0 0 0 0 0 0 0 0 0 0 0 0 0 0 0 0 0 0 0 0 0 0 0 0 0 0 0 0 0 0 0 0 0 0 0 0 4 
0 0 0 1 2 2 2 2 2 2 2 2 2 2 2 2 2 2 2 2 2 2 2 3 0 0 0 0 0 0 0 0 0 0 0 0 1 2 2 2 2 2 2 2 3 0 0 0 0 4 
0 0 0 4 0 0 0 0 0 0 0 0 0 0 0 0 0 0 0 0 0 0 0 0 0 0 0 0 0 0 0 0 0 0 0 0 4 5 5 9 13 13 0 0 0 0 0 0 0 4 
0 0 0 4 0 0 0 0 0 0 0 0 0 0 0 0 0 0 0 0 0 0 0 0 0 0 0 0 0 0 0 0 0 0 0 0 4 5 6 13 13 13 13 0 0 0 0 0 13 4 
0 0 0 4 0 0 0 0 0 0 0 10 0 0 0 0 0 0 0 0 0 0 0 0 0 0 0 0 0 0 0 0 0 0 0 0 7 8 8 2 2 3 0 0 0 0 13 13 1 6 
0 0 0 4 0 0 0 0 0 0 1 2 3 0 0 0 0 1 2 3 0 0 0 0 0 0 0 0 0 0 0 0 0 0 0 0 0 0 13 13 13 4 0 0 0 0 1 2 5 6 
0 0 0 4 0 0 0 0 1 2 5 5 6 0 0 0 0 13 13 4 0 0 0 0 0 0 0 0 0 0 0 0 0 0 0 0 0 0 13 13 13 4 0 0 0 0 7 8 8 6 
0 0 0 4 0 0 1 2 8 8 8 8 8 2 2 3 0 0 13 4 0 0 0 0 0 0 0 0 0 0 0 0 0 0 0 0 0 0 13 13 13 4 0 0 0 0 0 0 0 4 
0 0 0 4 0 0 0 0 0 0 0 0 0 0 0 0 0 13 1 6 0 0 0 0 0 0 0 0 0 0 0 0 0 0 0 0 0 0 1 2 2 5 3 0 0 0 0 0 0 4 
0 0 0 4 0 0 0 0 0 0 0 0 0 0 0 0 13 13 4 6 0 0 0 0 0 0 0 0 0 0 0 0 0 0 0 0 0 0 4 8 8 8 9 0 0 0 0 13 13 4 
0 0 0 4 0 0 0 0 0 0 0 0 13 13 13 13 1 2 8 9 0 0 0 0 0 0 0 0 0 0 0 0 0 0 0 0 1 2 9 0 0 0 0 0 0 0 13 13 13 4 
0 0 0 4 0 0 0 0 0 0 0 0 1 2 2 2 8 9 0 0 0 0 0 0 0 0 0 0 0 0 0 0 0 0 0 0 4 0 0 0 0 0 0 0 0 13 13 1 2 6 
0 0 0 4 2 3 0 0 0 0 0 0 0 0 0 0 0 0 0 0 0 0 0 0 0 0 0 0 0 0 0 0 0 0 0 0 4 0 0 0 0 0 0 0 0 13 13 4 5 6 
0 0 0 4 5 6 0 0 0 0 0 0 0 0 0 0 0 0 0 0 0 0 0 0 0 0 0 1 2 2 2 2 2 2 2 2 9 0 0 0 0 0 0 0 0 1 2 8 8 9 
0 0 0 4 5 5 2 2 3 0 0 0 0 0 0 0 0 0 0 0 0 0 0 0 0 0 0 0 0 0 0 0 0 0 0 0 0 0 0 0 0 0 0 0 0 4 6 0 0 0 
0 0 0 4 5 5 5 5 6 0 0 0 0 0 0 0 0 0 0 0 0 0 0 0 0 0 0 0 0 0 0 0 0 0 0 0 0 0 0 0 0 0 13 13 0 4 6 0 0 0 
0 0 0 4 8 8 5 5 5 2 2 2 3 0 0 0 0 0 0 0 0 0 0 0 0 0 0 0 0 0 0 0 0 0 0 0 0 0 0 0 0 1 2 2 2 8 6 0 0 0 
0 0 0 4 13 13 7 8 5 5 5 5 6 0 0 0 0 0 0 0 0 0 0 0 0 0 0 0 0 0 0 0 0 0 0 0 0 0 0 0 0 0 0 0 0 0 4 0 0 0 
0 0 0 4 13 13 13 0 7 8 8 8 8 2 2 3 0 0 0 0 0 0 0 0 0 0 0 0 0 0 0 0 0 0 0 0 0 13 13 1 2 3 0 0 0 0 4 0 0 0 
0 0 0 4 13 0 0 0 0 0 0 0 0 13 13 4 0 0 0 0 0 0 0 0 0 0 0 0 0 0 0 0 0 0 0 0 1 2 2 5 5 5 2 3 0 0 4 0 0 0 
0 0 0 4 0 0 0 0 0 0 0 0 0 13 13 4 3 0 0 0 0 0 0 0 0 0 0 0 0 0 0 0 0 0 0 0 7 8 8 8 8 8 8 9 13 13 4 0 0 0 
0 0 0 4 0 0 1 2 2 2 2 2 3 0 0 4 6 0 0 0 0 0 0 0 0 0 0 0 0 0 0 0 13 13 0 0 0 0 0 0 0 0 0 13 13 13 4 0 0 0 
0 0 0 4 0 0 0 0 0 0 0 0 4 0 0 7 9 0 0 0 0 0 0 0 0 0 0 0 0 0 0 1 2 2 3 0 0 0 0 0 0 0 0 13 13 13 4 0 0 0 
0 1 2 9 0 0 0 0 0 10 0 0 4 0 0 0 0 0 0 0 0 0 0 1 2 2 2 2 2 2 2 8 8 8 8 2 2 2 2 2 2 2 2 2 2 2 9 0 0 0 
1 9 0 0 0 0 0 0 1 2 3 0 4 0 0 0 0 0 0 0 0 0 0 4 0 0 0 0 0 0 0 0 0 0 0 0 0 0 0 0 0 0 0 0 0 0 0 0 0 0 
4 13 0 0 0 0 0 0 0 0 0 0 7 2 2 2 2 2 3 0 0 0 0 4 0 0 0 0 0 0 0 0 0 0 0 0 0 0 0 0 0 0 0 0 0 0 0 0 0 0 
4 13 13 13 0 0 0 0 0 0 0 0 0 0 0 0 0 0 0 0 0 0 0 4 0 0 0 0 0 0 0 0 0 0 0 0 0 0 0 0 0 0 0 0 0 0 0 0 0 0 
7 2 2 2 2 2 2 2 2 2 2 2 2 2 2 2 2 2 2 2 2 2 2 9 0 0 0 0 0 0 0 0 0 0 0 0 0 0 0 0 0 0 0 0 0 0 0 0 0 0 