0 0 0 0 0 0 0 0 0 0 0 0 0 0 0 0 0 0 0 0 0 0 0 0 0 0 0 0 0 1 2 2 2 2 2 3 0 0 0 0 0 0 0 0 0 0 0 0 0 0 0 0 0 0 0 0 0 0 0 0 0 0 0 0 0 0 0 0 0 0 0 0 0 0 0 0 0 0 0 0 0 0 0 0 0 0 0 0 
0 0 0 0 0 0 0 0 0 0 0 0 0 0 0 0 0 0 0 0 0 0 0 0 1 2 2 2 2 8 8 8 8 8 8 5 3 0 0 0 0 0 0 0 0 0 0 0 0 0 1 2 2 2 2 2 2 3 0 0 0 0 0 0 0 0 0 0 0 0 0 0 0 0 0 0 0 0 0 0 0 0 0 0 0 0 0 0 
0 0 0 0 0 0 0 0 0 0 0 0 0 0 0 0 0 0 0 0 0 0 0 1 5 8 8 8 9 0 0 0 0 0 0 4 6 0 0 0 0 0 0 0 0 0 1 2 2 2 5 5 5 5 5 5 5 5 2 2 3 0 0 0 0 0 0 0 0 0 0 0 0 1 3 0 0 0 0 0 0 0 0 0 0 0 0 0 
0 0 0 0 0 0 0 0 0 0 0 0 0 0 0 0 0 0 0 0 0 0 1 5 9 13 13 0 0 0 0 0 0 10 0 4 6 0 0 0 0 0 0 0 0 1 5 8 8 8 8 8 8 8 8 8 8 8 8 5 5 2 2 2 3 0 1 2 2 2 2 2 2 5 5 2 2 3 0 0 0 0 0 0 0 0 0 0 
0 0 0 0 0 0 0 0 0 0 0 0 0 0 0 0 0 0 0 0 0 0 4 6 13 13 0 0 0 0 0 1 2 2 2 5 5 3 0 0 0 0 0 0 0 4 6 12 12 0 0 0 0 0 0 0 0 0 0 7 8 8 8 8 6 0 4 8 8 8 8 8 8 8 8 8 5 5 3 0 0 0 0 0 0 0 0 0 
0 0 0 0 0 0 0 0 0 0 0 0 0 0 0 0 0 0 0 0 0 1 5 9 0 0 0 0 0 0 0 0 12 12 12 7 8 5 3 0 0 0 0 0 0 4 9 12 0 0 0 0 0 0 0 0 0 0 0 0 0 0 0 0 4 2 6 0 0 0 13 13 13 13 0 0 7 5 6 0 0 0 0 0 0 0 0 0 
0 0 0 0 0 0 0 0 0 0 0 0 0 0 0 0 0 0 0 0 1 5 6 0 0 0 11 0 0 0 0 0 0 0 0 0 0 4 6 0 0 0 0 0 1 6 12 0 0 0 0 0 0 13 13 0 0 0 0 0 0 0 0 0 7 8 9 0 0 0 1 2 2 3 10 0 0 4 6 0 0 0 0 0 0 0 0 0 
0 0 0 0 0 0 0 0 0 0 0 0 0 0 0 0 0 0 0 0 4 5 8 2 2 2 2 2 2 3 0 0 0 0 0 0 0 4 6 0 0 0 0 0 4 6 0 0 0 0 0 0 0 1 3 0 0 0 0 0 0 0 0 0 0 0 0 0 0 0 0 12 12 4 3 0 0 4 6 0 0 0 0 0 0 0 0 0 
0 0 0 0 0 0 0 0 0 0 0 0 0 0 0 0 0 0 0 0 4 6 0 0 0 0 0 0 0 0 0 0 0 0 0 0 0 4 6 0 0 0 0 0 4 6 0 0 0 0 0 0 0 4 6 0 0 10 0 0 0 0 0 0 0 0 0 0 0 0 0 0 0 7 9 0 0 4 6 0 0 0 0 0 0 0 0 0 
0 0 0 0 0 0 0 0 0 0 0 0 0 0 0 0 0 0 0 0 4 6 13 13 13 13 13 0 0 0 0 0 0 0 0 0 0 4 9 0 0 0 0 0 4 6 0 0 0 0 0 0 0 4 5 2 2 2 2 3 0 0 0 0 0 0 0 0 0 0 0 0 0 0 0 0 0 4 6 0 0 0 0 0 0 0 0 0 
0 0 0 0 0 0 0 0 0 0 1 3 0 0 0 0 0 0 0 0 4 5 2 2 2 2 3 0 0 0 0 0 0 0 0 1 2 9 0 0 0 0 0 0 4 5 3 0 0 0 0 0 0 7 5 5 5 5 5 5 2 2 3 0 0 0 0 0 0 0 1 2 2 2 2 2 2 5 6 0 0 0 0 0 0 0 0 0 
0 0 0 0 0 0 0 0 1 2 5 5 2 2 2 3 0 0 1 2 5 5 8 8 8 5 6 0 0 0 0 0 0 1 2 8 9 0 0 0 0 0 0 0 7 8 5 3 0 0 0 0 0 0 7 8 8 8 8 8 8 8 8 3 0 1 3 0 0 0 0 0 0 0 0 0 12 4 6 0 0 0 0 0 0 0 0 0 
0 0 0 0 0 0 0 1 5 8 8 8 8 8 8 5 2 2 8 8 8 6 12 12 12 4 9 0 0 1 3 0 0 4 6 0 0 0 0 0 0 0 0 0 0 0 4 6 0 0 0 0 0 0 0 0 0 0 0 0 0 0 0 0 0 7 5 2 3 0 0 0 0 0 0 0 0 4 6 0 0 0 0 0 0 0 0 0 
0 0 0 0 0 0 1 5 9 13 13 13 13 13 12 7 8 9 12 13 13 4 2 2 2 6 0 0 0 4 6 0 0 7 5 3 0 0 0 0 0 0 0 0 0 0 4 5 3 0 0 0 0 0 0 0 0 0 0 0 0 0 0 0 0 12 7 5 6 0 0 0 0 0 0 0 0 4 6 0 0 0 0 0 0 0 0 0 
0 0 0 0 0 1 5 9 0 0 0 0 0 0 0 13 13 13 0 0 0 7 8 5 5 6 0 0 0 4 9 0 0 0 7 8 2 2 3 0 0 0 0 0 0 0 4 5 5 3 0 0 0 0 0 0 0 0 0 0 0 0 0 0 0 0 12 7 5 2 2 3 0 0 0 0 0 4 6 0 0 0 0 0 0 0 0 0 
0 0 0 0 1 5 9 12 0 0 1 3 0 0 0 0 0 0 0 0 0 0 0 7 8 9 0 0 1 9 12 0 0 0 0 0 0 7 5 2 2 2 2 2 2 2 8 8 8 5 3 0 0 0 0 0 0 0 0 0 0 0 0 0 0 0 0 12 7 8 8 9 0 0 0 0 1 5 9 0 0 0 0 0 0 0 0 0 
0 0 0 0 4 6 12 0 0 0 4 5 2 3 0 0 0 0 0 1 3 0 0 0 0 13 13 0 0 0 0 0 0 0 0 0 0 12 4 5 9 12 0 0 0 0 0 0 12 7 5 3 0 0 0 0 0 0 0 0 0 0 0 0 0 0 0 0 0 0 0 0 0 0 0 0 4 6 0 0 0 0 0 0 0 0 0 0 
0 0 0 1 5 6 0 0 0 0 7 8 8 5 2 3 0 0 0 4 5 3 0 0 0 1 3 0 0 0 0 0 0 0 0 0 0 12 4 6 0 0 0 0 0 0 0 0 0 12 4 6 0 0 0 0 0 0 0 0 0 0 0 0 0 0 0 0 0 0 0 0 0 0 0 0 4 5 2 2 2 2 3 0 0 0 0 0 
0 0 0 4 5 6 0 10 0 0 0 0 0 7 8 9 0 0 0 7 8 9 0 0 0 7 8 3 0 0 0 0 0 0 0 0 0 12 4 6 0 10 1 3 0 0 0 0 0 12 7 5 3 0 0 0 0 0 0 0 0 0 0 0 0 0 0 0 0 0 0 0 0 1 2 2 5 5 8 8 8 8 5 3 0 0 0 0 
0 0 0 7 8 5 2 3 0 0 0 0 0 0 0 0 0 0 0 0 0 0 0 0 0 0 0 0 0 0 0 0 0 0 0 0 0 12 4 5 2 2 6 0 0 0 0 0 0 0 12 4 6 0 0 0 0 0 0 0 0 0 0 0 0 0 0 0 0 0 0 0 1 5 8 8 5 6 13 13 13 13 4 5 2 3 0 0 
0 0 0 0 0 7 5 5 2 2 2 3 0 0 0 0 0 0 0 0 0 0 0 0 0 0 0 0 0 0 0 0 0 0 0 0 0 1 5 9 12 7 9 0 0 13 13 0 0 0 0 4 6 0 0 0 0 0 1 2 2 2 2 2 3 0 0 0 0 0 0 1 5 9 12 0 7 9 13 1 3 13 7 8 8 5 3 0 
0 0 0 0 0 0 4 6 12 0 0 0 0 0 0 0 0 0 0 1 2 2 2 2 2 2 2 2 2 2 2 2 2 2 2 2 2 5 9 12 0 0 0 0 0 1 3 13 13 0 0 4 6 0 0 0 0 0 0 0 0 0 0 0 4 0 0 0 0 0 0 4 6 12 0 0 0 0 0 0 0 0 0 0 0 4 6 0 
0 0 0 0 0 1 5 6 0 0 0 0 0 0 0 0 0 0 0 4 5 8 8 8 8 8 8 8 8 8 8 8 8 8 8 8 8 9 12 0 0 0 0 0 0 7 8 2 3 0 0 4 6 0 0 0 0 0 0 0 0 0 0 0 4 0 0 1 3 0 0 7 6 0 0 0 1 2 2 2 2 2 3 10 1 8 9 0 
0 0 0 0 0 7 5 6 13 13 0 0 0 0 0 0 0 0 1 5 9 12 0 0 0 0 0 0 0 0 0 0 0 0 0 0 0 0 0 0 0 0 0 0 0 0 0 0 0 0 0 4 6 0 0 0 0 0 0 0 0 0 0 0 4 0 0 0 0 0 0 0 4 3 0 1 9 13 13 13 13 13 7 2 6 0 0 0 
0 0 0 0 0 0 4 6 13 13 1 3 0 0 0 0 0 1 5 6 12 0 0 0 0 0 0 0 0 0 0 0 0 0 0 0 0 0 0 0 0 0 0 0 0 13 13 13 13 0 1 5 9 0 0 0 0 0 0 0 0 0 0 0 7 2 3 0 0 0 0 0 4 6 0 0 0 0 0 0 0 0 0 7 5 3 0 0 
0 0 0 0 0 0 7 5 2 2 5 5 3 0 0 0 0 4 5 6 0 0 0 0 1 2 2 2 2 2 2 2 3 0 0 0 0 0 0 0 0 0 0 0 1 2 2 2 2 2 5 9 12 0 0 0 0 0 0 0 0 0 0 0 0 0 7 2 3 0 0 0 7 8 2 2 2 2 2 2 3 0 0 0 4 6 0 0 
0 0 0 0 0 0 0 7 8 5 5 5 6 0 0 0 1 8 8 6 0 0 0 0 7 8 9 0 0 0 0 10 4 3 0 0 0 0 0 0 0 0 1 2 5 5 5 8 8 8 9 12 0 0 0 0 0 0 0 0 0 0 0 0 0 0 0 0 4 0 0 0 0 0 0 0 0 0 0 0 4 0 0 0 4 6 0 0 
0 0 0 0 0 0 0 0 0 7 8 5 6 0 0 0 0 0 0 7 3 0 13 13 13 13 13 13 13 0 0 1 8 9 0 0 0 0 0 0 0 1 5 5 5 8 9 12 0 0 0 0 0 0 0 0 0 0 0 0 0 0 0 0 0 0 0 0 7 2 2 2 2 2 2 2 2 3 0 0 4 0 0 0 4 6 0 0 
0 0 0 1 2 2 3 0 0 0 0 4 6 0 0 0 0 0 0 0 7 2 2 2 2 2 2 2 2 2 2 9 12 12 0 0 0 0 0 0 0 4 5 5 9 12 0 0 0 0 0 0 0 0 0 10 0 0 0 0 0 0 0 0 0 0 0 0 0 0 0 0 0 0 0 4 6 0 0 1 9 0 0 1 5 6 0 0 
0 0 0 4 8 8 5 2 2 2 2 5 5 2 2 3 0 0 0 0 0 0 0 0 0 13 13 0 0 0 0 0 0 0 0 0 0 1 3 12 12 4 8 6 12 0 0 0 0 0 0 0 0 0 0 0 0 0 0 0 0 0 0 0 0 0 0 0 0 0 0 0 0 0 0 7 6 0 0 0 0 0 0 0 4 6 0 0 
0 0 1 6 13 13 7 8 8 5 5 5 5 8 8 8 3 0 0 0 0 0 0 0 13 0 0 13 0 0 0 0 0 0 0 0 0 4 8 2 2 9 0 4 0 0 0 0 0 0 0 0 0 0 1 2 3 0 0 0 0 0 0 0 0 0 0 0 0 0 0 0 0 0 0 0 7 2 2 2 2 3 0 0 7 5 3 0 
0 0 4 6 13 13 13 0 0 7 8 8 9 0 0 0 0 0 0 1 0 0 0 0 1 2 2 3 0 0 0 0 0 0 0 0 0 4 0 0 0 0 0 4 13 0 0 0 0 0 0 0 1 2 5 5 5 3 0 0 0 0 0 0 0 0 0 0 0 0 0 0 0 0 0 0 0 0 0 0 0 0 0 0 0 4 5 3 
0 0 4 5 3 13 0 0 0 0 0 0 0 0 0 0 0 0 0 4 0 0 0 1 5 5 5 5 2 3 0 0 0 0 0 1 2 9 0 0 0 0 0 4 13 13 0 0 0 0 0 1 5 5 5 5 5 6 13 13 13 1 2 3 0 0 0 0 0 0 0 0 0 0 0 0 0 0 0 0 0 0 0 0 0 4 5 6 
0 0 7 5 6 0 0 0 0 0 0 0 1 3 0 0 0 0 0 4 2 2 2 5 8 8 8 8 8 5 2 2 2 2 2 9 0 0 0 1 2 2 2 6 13 13 13 0 0 0 0 7 8 8 8 5 5 5 2 2 2 5 5 6 0 0 0 0 0 0 0 0 0 0 0 0 0 1 2 2 2 2 2 2 2 8 5 6 
0 0 0 4 6 0 0 0 0 0 0 1 6 12 0 0 0 0 0 7 5 5 5 9 12 0 0 0 0 7 8 8 8 8 6 0 0 1 2 8 8 5 5 5 2 2 2 3 0 0 0 0 0 0 12 7 8 5 5 5 5 8 8 5 2 2 3 0 0 0 0 1 2 3 0 0 0 0 0 0 0 0 0 12 12 12 4 6 
0 0 0 4 5 2 3 0 0 0 1 5 5 2 3 0 0 0 0 0 4 5 9 12 0 0 0 0 10 0 0 0 0 0 7 2 2 6 0 0 0 7 8 8 8 8 8 8 3 0 0 0 0 0 0 0 12 7 8 8 9 12 12 7 8 8 9 0 0 0 0 12 7 5 2 3 0 0 0 0 0 0 0 13 12 12 4 6 
0 0 0 4 6 12 0 0 0 0 7 8 8 8 8 3 0 0 0 0 4 6 0 0 0 0 0 0 1 3 0 0 0 0 0 4 5 6 0 1 0 0 0 0 0 0 0 0 0 0 0 0 0 0 0 0 0 0 0 0 0 0 0 0 0 0 0 0 0 0 0 0 12 7 8 8 2 3 0 0 0 0 0 13 13 12 4 6 
0 0 1 5 9 0 0 0 0 0 0 12 12 12 0 0 0 0 0 0 4 6 0 0 0 0 0 1 8 8 2 2 2 3 0 4 5 6 0 4 10 0 0 0 0 0 0 0 0 0 0 0 0 0 0 0 0 0 0 0 0 0 0 0 0 0 0 0 0 0 0 0 0 0 0 0 0 0 0 0 0 0 0 13 13 13 4 6 
0 0 4 6 0 0 0 0 0 0 0 0 0 0 0 0 0 0 0 0 4 9 0 0 1 13 13 13 13 13 13 13 0 0 0 4 5 9 0 4 2 3 0 0 0 0 0 0 0 0 0 0 0 0 0 0 0 0 0 0 0 0 0 0 0 0 0 0 0 0 0 0 0 0 0 0 0 0 0 0 0 0 0 0 13 13 4 6 
0 1 5 9 0 0 1 2 3 0 0 0 0 0 0 0 1 2 2 2 9 0 0 0 7 2 2 2 2 2 2 3 12 0 0 7 9 12 0 7 9 12 0 0 0 0 0 0 0 0 0 0 0 0 0 0 0 0 0 0 0 0 0 0 0 0 0 0 0 0 0 0 0 0 0 1 2 2 2 3 0 0 0 13 13 13 4 6 
0 4 6 0 0 0 4 5 5 3 0 0 0 0 0 0 0 0 0 0 0 0 0 0 0 0 0 0 0 0 0 0 0 0 0 0 0 0 0 0 0 0 0 0 0 0 0 0 0 0 0 0 0 0 0 0 0 0 0 0 0 0 0 0 13 13 13 13 0 0 0 0 0 0 1 8 5 5 5 8 3 0 0 13 13 12 4 6 
1 5 6 13 13 1 5 5 5 5 2 2 3 0 0 0 0 0 0 0 0 0 0 0 0 0 0 0 0 0 0 0 0 0 0 0 0 0 0 0 0 0 0 0 0 0 1 2 2 2 2 2 2 2 2 2 2 3 0 0 0 0 0 0 1 2 2 3 0 0 0 0 0 1 6 0 4 8 6 0 4 3 0 13 12 12 4 6 
4 5 6 13 13 7 8 8 8 8 8 8 8 2 2 2 2 2 2 2 2 2 2 2 2 2 2 2 2 2 2 2 2 2 2 3 0 0 0 0 0 0 0 1 2 2 5 8 8 5 5 5 8 8 8 8 5 6 0 0 0 0 0 0 0 0 0 0 0 0 0 0 0 4 5 2 6 0 4 2 5 5 2 2 2 2 5 9 
7 5 6 13 13 13 13 13 13 13 13 13 13 13 13 13 13 13 4 5 8 8 8 8 8 8 8 8 8 8 8 8 8 8 5 6 0 0 0 0 0 0 0 4 5 8 9 0 0 7 8 9 0 0 0 0 7 6 0 0 0 0 0 0 0 0 0 0 0 0 0 0 0 4 5 5 8 2 8 5 5 5 5 8 8 8 9 0 
0 7 5 2 2 2 2 2 2 2 2 2 2 2 2 2 2 2 5 6 0 0 0 0 0 0 0 0 0 0 0 0 0 0 7 5 3 13 13 13 13 13 13 4 6 0 0 0 0 0 0 0 0 0 0 0 0 4 0 0 0 0 0 0 0 0 0 1 2 3 0 0 0 7 5 6 0 0 0 4 5 5 6 0 0 0 0 0 
0 0 7 8 8 8 8 8 8 8 8 8 8 8 8 8 8 8 8 9 0 0 0 0 0 0 0 0 0 0 0 0 0 0 0 7 5 2 2 2 2 2 2 5 9 0 0 0 0 0 0 0 0 0 0 0 1 6 0 0 0 0 0 0 0 0 0 0 7 8 3 0 0 0 7 8 2 2 2 8 8 5 6 0 0 0 0 0 
0 0 0 0 0 0 0 0 0 0 0 0 0 0 0 0 0 0 0 0 0 0 0 0 0 0 0 0 0 0 0 0 0 0 0 0 7 8 8 8 8 8 8 9 0 0 0 0 0 0 0 0 0 0 0 0 4 6 0 0 0 0 0 0 0 0 0 0 0 0 0 0 0 0 0 0 0 0 0 0 12 7 6 0 0 0 0 0 
0 0 0 0 0 0 0 0 0 0 0 0 0 0 0 0 0 0 0 0 0 0 0 0 0 0 0 0 0 0 0 0 0 0 0 0 0 0 0 0 0 0 0 0 0 0 0 0 0 0 0 0 0 0 0 0 4 6 0 0 0 0 0 0 0 0 0 0 0 0 0 0 0 0 0 0 0 0 0 0 0 12 4 3 0 0 0 0 
0 0 0 0 0 0 0 0 0 0 0 0 0 0 0 0 0 0 0 0 0 0 0 0 0 0 0 0 0 0 0 0 0 0 0 0 0 0 0 0 0 0 0 0 0 0 0 0 0 0 0 0 0 0 0 0 7 5 2 3 0 0 1 3 0 0 1 0 1 0 0 1 2 2 2 3 0 0 0 0 0 0 4 6 0 0 0 0 
0 0 0 0 0 0 0 0 0 0 0 0 0 0 0 0 0 0 0 0 0 0 0 0 0 0 0 0 0 0 0 0 0 0 0 0 0 0 0 0 0 0 0 0 0 0 0 0 0 0 0 0 0 0 0 0 0 7 8 8 2 2 5 5 2 2 6 0 4 2 2 8 8 8 8 8 2 3 0 0 0 0 4 6 0 0 0 0 
0 0 0 0 0 0 0 0 0 0 0 0 0 0 0 0 0 0 0 0 0 0 0 0 0 0 0 0 0 0 0 0 0 0 0 0 0 0 0 0 0 0 0 0 0 0 0 0 0 1 2 3 0 0 0 0 0 0 0 0 0 7 8 9 0 0 4 0 4 12 0 0 12 12 12 0 0 0 0 0 0 0 4 6 0 0 0 0 
0 0 0 0 0 0 0 0 0 0 0 0 0 0 0 0 0 0 0 0 0 0 0 0 0 0 0 0 0 0 0 0 0 0 0 0 0 0 0 0 0 0 0 0 0 0 0 0 0 7 8 5 3 0 0 0 1 2 3 0 0 0 0 0 0 1 6 0 7 3 0 0 0 0 0 0 0 0 0 13 13 13 4 6 0 0 0 0 
0 0 0 0 0 0 0 0 0 0 0 0 0 0 0 0 0 0 0 0 0 0 0 0 0 0 0 0 0 0 0 0 0 0 0 0 0 0 0 0 0 0 0 0 0 0 0 0 0 0 0 7 8 2 2 2 5 8 9 0 1 2 2 2 2 8 9 0 0 0 0 0 0 10 0 0 0 0 0 1 2 2 5 9 0 0 0 0 
0 0 0 0 0 0 0 0 0 0 0 0 0 0 0 0 0 0 0 0 0 0 0 0 0 0 0 0 0 0 0 0 0 0 0 0 0 0 0 0 0 0 0 0 0 0 0 0 0 0 0 0 0 7 8 8 9 0 0 0 0 4 6 12 0 0 0 0 0 0 0 0 0 0 0 0 0 0 0 4 5 8 9 0 0 0 0 0 
0 0 0 0 0 0 0 0 0 0 0 0 0 0 0 0 0 0 0 0 0 0 0 0 0 0 0 0 0 0 0 0 0 0 0 0 0 0 0 0 0 0 0 0 0 0 0 0 0 0 0 0 0 0 0 0 0 0 0 0 0 7 6 12 12 12 12 0 0 0 0 1 2 2 2 2 2 2 2 5 9 0 0 0 0 0 0 0 
0 0 0 0 0 0 0 0 0 0 0 0 0 0 0 0 0 0 0 0 0 0 0 0 0 0 0 0 0 0 0 0 0 0 0 0 0 0 0 0 0 0 0 0 0 0 0 0 0 0 0 0 0 0 0 0 0 0 0 0 0 0 7 2 2 2 2 2 2 2 2 8 8 8 8 8 8 8 8 9 0 0 0 0 0 0 0 0 