0 0 0 0 0 0 0 0 0 0 0 0 0 0 0 0 0 0 0 0 0 0 1 2 2 2 3 
0 0 0 0 0 0 0 0 0 0 0 0 0 0 0 0 0 0 0 0 0 1 5 5 5 5 6 
0 0 0 11 0 0 0 0 0 0 0 0 0 0 0 0 0 0 0 0 1 5 5 5 5 5 6 
1 2 2 2 2 3 0 0 0 0 1 2 2 2 2 2 2 2 2 2 8 8 8 8 8 8 9 
0 0 0 0 7 5 3 0 0 1 5 9 0 0 0 0 0 0 0 0 0 0 0 0 0 0 0 
0 0 0 0 0 4 6 0 0 7 9 0 0 0 0 0 0 0 0 0 0 0 0 0 0 0 0 
0 0 0 0 0 7 5 3 0 0 0 0 0 0 0 0 0 0 0 0 0 0 0 0 0 0 0 
0 0 0 0 0 0 4 6 0 0 0 0 0 0 0 0 0 0 0 0 0 0 0 0 0 0 0 
0 0 0 0 0 0 7 5 2 2 3 13 13 13 1 2 2 3 0 0 0 1 2 3 0 0 0 
0 0 0 0 0 0 0 7 8 8 9 13 13 13 7 8 8 8 2 2 2 8 8 9 0 0 0 
0 0 0 0 0 0 0 0 0 0 0 0 0 0 0 0 0 0 0 0 0 0 0 0 0 0 0 
0 0 0 0 0 0 0 0 0 0 0 0 0 0 0 0 0 0 0 0 0 0 0 0 0 0 0 
0 0 0 0 0 0 0 0 0 0 0 0 0 0 0 0 0 1 2 3 0 0 0 0 1 2 3 
0 0 0 0 0 0 0 0 0 0 0 0 0 0 0 0 0 7 8 8 2 2 2 2 8 8 9 