12 12 12 0 0 0 0 0 0 0 0 0 0 0 0 0 0 0 0 0 0 0 0 0 0 0 0 12 12 12 12 12 12 12 12 
0 0 1 0 0 0 0 0 0 0 0 0 0 0 0 0 0 0 0 0 0 0 0 0 0 0 0 1 0 0 0 0 0 0 0 
0 0 4 0 0 0 0 0 0 0 0 0 0 0 0 0 0 0 0 0 0 0 0 0 0 0 0 4 0 0 0 0 0 0 0 
0 0 4 0 0 0 0 0 0 0 0 0 0 0 0 0 0 0 0 0 0 0 0 0 0 0 0 4 0 0 0 0 0 0 0 
0 0 4 0 0 0 0 0 0 0 0 0 0 0 0 0 0 0 0 0 0 0 0 0 0 0 0 4 0 0 0 0 0 0 0 
0 0 4 0 0 0 0 0 0 0 0 0 0 0 0 0 0 0 0 0 0 0 0 0 0 0 0 4 0 0 0 0 0 0 0 
0 0 4 12 0 0 0 0 0 0 0 0 0 0 0 0 0 0 0 0 0 0 13 13 13 13 13 4 0 0 0 0 0 0 0 
0 0 4 3 0 0 0 13 1 3 12 0 0 0 0 0 0 0 0 0 0 0 1 2 2 2 2 6 0 0 0 0 0 0 0 
0 0 4 6 0 0 13 13 4 5 3 0 0 0 0 0 0 0 0 0 0 0 4 8 8 8 5 6 0 0 0 0 0 0 0 
0 0 4 6 0 0 1 2 8 8 9 0 0 0 0 0 0 10 0 0 0 0 4 13 10 13 4 6 0 0 0 0 0 0 0 
0 0 4 6 0 0 7 6 10 0 0 0 0 0 0 0 1 2 3 12 12 12 4 13 1 13 4 6 0 0 0 0 0 0 0 
0 0 4 6 0 0 0 7 2 3 0 0 0 0 1 2 9 12 7 2 2 2 9 13 13 13 4 6 0 0 0 0 0 0 0 
0 0 4 5 3 13 0 0 7 8 2 3 0 0 0 0 0 0 0 0 0 0 0 0 0 1 5 6 0 0 0 0 0 0 0 
0 0 7 5 6 13 13 0 0 0 0 0 0 0 0 0 0 0 0 0 0 0 0 0 0 0 4 9 0 0 0 0 0 0 0 
0 0 0 7 5 2 3 0 0 0 0 0 0 0 0 1 2 3 0 0 0 0 0 0 0 0 4 0 0 0 0 0 0 0 0 
0 0 0 0 7 8 5 2 2 2 3 0 0 0 0 0 0 7 0 0 0 0 1 2 2 2 6 0 0 0 0 0 0 0 0 
0 0 0 0 0 0 4 6 12 12 4 0 0 0 1 3 10 0 0 0 0 0 4 0 0 0 4 0 0 0 0 0 0 0 0 
0 0 0 0 0 0 4 6 13 13 4 0 0 0 0 7 2 2 3 0 0 0 4 0 0 1 9 0 0 0 0 0 0 0 0 
0 0 0 0 0 0 4 6 13 13 4 0 0 0 0 0 0 0 0 0 0 1 6 0 0 4 0 0 0 0 0 0 0 0 0 
0 0 0 0 0 0 4 6 0 0 7 2 2 3 0 0 0 0 0 0 0 4 6 0 0 4 0 0 0 0 0 0 0 0 0 
0 0 0 0 0 0 4 6 10 0 0 13 13 0 0 0 11 0 0 0 1 5 9 0 1 9 0 0 0 0 0 0 0 0 0 
0 0 0 0 0 0 7 5 3 0 0 0 0 0 0 0 1 3 0 0 4 6 0 0 4 0 0 0 0 0 0 0 0 0 0 
0 0 0 0 0 0 0 4 6 0 0 0 0 0 0 0 0 7 2 2 5 6 0 0 4 0 0 0 0 0 0 0 0 0 0 
0 0 0 0 0 0 0 4 6 0 0 0 0 0 0 0 13 13 13 13 4 6 0 0 4 3 0 0 0 0 0 0 0 0 0 
0 0 0 0 0 0 0 7 5 2 3 0 0 0 0 0 1 2 2 2 5 6 0 0 4 9 0 0 0 0 0 0 0 0 0 
0 0 0 0 0 0 0 0 7 8 8 2 2 2 2 2 8 8 8 8 8 8 2 2 9 0 0 0 0 0 0 0 0 0 0 